11111111111111
10000000000111
100000000P1111
10000000100001
1CC00000000001
101100E0000001
11111111111111