11111111111111
10C00C00000111
111000P0001111
100000001E0001
100000C0000001
10110000000001
11111111111111