11111111111111
10C10C00000111
1110000P001111
100000001E0001
1CC000C0000001
10110000000001
11111111111111