11111111111111
10C00C00000111
111000P0001111
100000001E0001
100000C0001111
10110000001C01
11111111111111