11111111111111
10000000000111
1000000P001111
10000000100001
1CC000C0000001
101100E0000001
11111111111111