1111111111
1P00CE1111
1111111111